1 1 7 7 1 1 1 1 1 1 1 1 1 1 1 1 1 1 1 1 1 1 1 7 1 1 1 1 1 1 1 1 1 1 1 1 1 1 1 1 1 1 1 1 1 1 1 1 1 1
1 1 1 7 7 1 1 1 9 1 1 1 1 1 1 1 1 1 1 1 1 1 1 7 1 1 1 9 1 1 1 1 1 1 1 1 9 1 1 1 1 1 1 1 1 1 1 9 1 1
1 1 1 1 7 7 1 1 1 1 1 1 1 1 1 9 1 1 1 9 1 1 1 7 1 1 1 1 1 1 1 1 1 1 1 1 1 1 1 1 1 1 1 1 1 1 1 1 1 1
1 1 1 1 1 7 7 1 1 1 1 1 1 1 1 1 1 1 1 1 1 1 1 7 7 1 1 1 1 1 1 1 9 1 1 1 1 1 1 1 1 1 9 1 1 1 1 1 1 1
1 1 1 1 1 1 7 7 1 1 1 9 1 1 1 1 1 1 1 1 1 1 1 7 1 7 1 1 1 1 1 1 1 1 1 1 1 1 1 1 1 1 1 1 1 1 1 1 1 1
1 9 1 1 1 1 1 1 7 1 1 1 1 1 1 1 1 1 1 1 9 1 1 7 1 1 7 1 1 1 9 1 1 1 1 1 1 1 1 1 1 1 1 1 1 1 1 1 1 1
1 1 1 1 1 9 1 1 1 7 1 1 1 1 9 1 1 1 1 1 1 1 7 7 1 1 7 1 1 1 1 1 1 1 1 1 1 1 1 9 1 1 1 1 9 1 1 1 1 1
1 1 1 1 1 1 1 1 1 7 7 1 1 1 1 1 1 1 1 1 1 7 1 7 1 1 7 7 1 1 1 1 1 1 1 9 1 1 1 1 1 1 1 1 1 1 1 1 1 1
1 1 1 1 1 1 1 1 1 1 7 7 1 1 1 1 1 9 1 1 7 1 1 7 1 1 1 1 7 7 7 7 1 1 1 1 1 1 1 1 1 1 1 1 1 1 1 9 1 1
1 1 1 1 1 1 1 1 1 1 1 1 7 1 1 1 1 1 1 7 1 1 1 7 1 9 1 1 1 1 1 1 7 1 1 1 1 1 1 1 1 1 1 1 1 1 1 1 1 1
1 1 1 1 9 1 1 1 1 1 9 1 1 7 1 1 1 1 7 1 1 1 1 7 1 1 1 1 1 1 1 1 7 7 1 1 1 1 1 1 1 1 1 9 1 1 1 1 1 1
1 1 1 1 1 1 1 1 1 1 1 1 1 1 7 1 1 7 1 1 1 1 1 7 1 1 1 1 1 1 1 1 1 7 1 1 1 1 1 1 1 1 1 1 1 1 1 1 1 1
1 1 1 1 1 1 1 1 1 1 1 1 1 1 1 7 1 7 1 1 9 1 1 7 1 1 1 9 1 1 1 1 1 1 7 1 1 1 9 1 1 1 1 1 1 1 1 1 1 1
1 1 1 1 1 1 1 1 1 1 1 1 1 1 1 1 7 1 1 1 1 1 1 7 1 1 1 1 1 1 1 1 1 1 1 7 1 1 1 1 1 1 1 1 1 1 1 1 1 1
1 9 1 1 1 1 1 1 9 1 1 1 1 1 1 7 1 9 1 1 1 9 1 7 1 1 1 1 1 1 1 9 1 1 1 7 7 1 1 1 1 9 1 1 1 1 9 1 1 1
1 1 1 1 1 1 1 1 1 1 1 1 1 7 7 1 1 1 1 1 1 1 1 7 1 1 1 1 1 1 1 1 1 1 1 1 7 7 1 1 1 1 1 1 1 1 1 1 1 1
1 1 1 1 1 1 1 1 1 1 1 1 7 7 1 9 1 1 1 9 1 1 1 7 1 1 9 1 1 1 1 1 1 1 1 1 1 7 7 1 1 1 1 1 1 1 1 1 1 1
1 1 1 9 1 1 1 1 1 1 1 7 7 1 1 1 1 9 1 1 1 1 1 7 1 1 1 1 1 1 1 1 9 1 1 1 1 1 7 7 1 1 1 1 1 1 9 1 1 1
1 1 1 1 1 1 1 1 1 1 7 7 1 9 1 1 1 1 1 9 1 1 1 7 1 1 1 1 1 1 1 1 1 1 1 1 1 1 1 7 7 7 1 1 1 1 1 1 1 1
1 1 1 1 1 1 1 9 1 7 7 1 1 1 9 1 1 9 1 1 1 1 7 7 1 1 1 1 9 1 1 1 1 1 1 1 9 1 1 1 1 7 7 1 9 1 1 1 1 1
1 9 1 1 1 1 1 1 7 7 1 9 1 1 1 1 1 1 1 1 9 1 7 1 1 1 1 1 1 1 1 1 9 1 1 1 1 1 1 1 7 7 7 1 1 1 1 1 1 1
1 1 1 1 1 1 1 7 7 7 1 1 1 9 1 1 9 1 1 1 1 1 7 1 1 1 1 1 1 1 1 1 1 1 1 1 1 1 1 7 7 1 1 7 1 1 1 1 1 1
7 7 7 7 7 7 7 1 1 1 1 1 9 1 1 1 1 1 1 1 1 1 7 1 1 1 9 1 1 1 1 1 1 1 1 1 1 1 1 7 1 1 1 7 7 1 1 1 1 1
1 9 1 1 1 9 1 1 9 1 1 1 1 1 1 9 1 1 9 1 1 1 7 1 1 1 1 1 1 1 1 1 1 1 1 1 1 1 7 7 1 1 1 1 7 7 1 1 1 1
1 1 9 1 1 1 1 1 1 1 1 9 1 1 1 1 1 1 1 1 9 1 7 1 1 1 1 1 1 1 1 1 9 1 1 1 1 7 7 1 1 1 9 1 1 7 1 1 1 1
1 1 1 1 1 1 1 9 1 3 3 3 3 3 1 1 1 9 1 1 1 1 7 1 1 1 1 1 1 1 1 1 1 1 1 1 7 7 1 1 1 1 1 1 1 1 7 1 1 1
1 1 1 9 1 1 1 1 1 3 1 6 1 3 9 1 9 1 1 1 1 1 7 1 1 1 1 9 1 1 1 1 1 1 1 7 7 1 1 9 1 1 1 1 1 1 1 7 1 1
1 9 1 1 1 1 1 1 1 3 1 1 1 3 1 1 1 1 1 9 1 1 7 7 1 1 1 1 1 1 1 1 9 1 7 7 1 1 1 1 1 1 1 9 1 1 1 1 7 1
1 1 1 1 1 9 1 1 1 3 1 1 1 3 1 9 1 1 1 1 1 1 7 1 7 1 1 1 1 1 1 1 1 7 7 1 1 1 1 1 1 1 1 1 1 1 1 1 7 7
7 7 1 1 1 1 1 1 1 3 3 5 3 3 1 1 1 1 1 9 1 1 7 1 7 7 1 1 1 9 1 1 7 7 1 1 1 1 1 1 1 1 1 1 1 1 1 1 1 1
1 7 7 1 1 9 1 1 9 1 9 1 1 1 1 1 1 1 9 1 1 1 7 1 1 7 1 1 1 1 1 7 7 1 1 1 1 1 1 1 1 1 1 1 1 1 1 1 1 1
1 1 7 7 1 1 1 1 1 9 1 1 1 9 1 9 1 1 1 1 1 1 7 1 1 7 7 1 1 1 7 7 1 1 1 9 1 1 1 1 1 9 1 1 1 1 1 1 1 1
1 1 1 7 7 1 1 9 1 1 1 9 1 1 1 1 1 9 1 1 9 1 7 1 1 1 7 1 1 7 7 1 1 1 1 1 1 1 1 1 1 1 1 1 1 1 1 9 1 1
1 1 1 1 7 7 1 1 1 1 1 1 1 1 9 1 1 1 1 1 1 1 7 1 1 1 7 7 7 7 1 1 1 1 1 1 1 1 1 1 1 1 1 1 1 1 1 1 1 1
1 9 1 1 1 7 7 1 1 9 1 1 1 1 9 1 1 1 9 1 1 1 7 1 1 1 7 7 7 1 1 9 1 1 1 1 1 1 1 1 1 9 1 1 1 1 1 1 1 1
1 1 1 1 1 1 7 7 1 1 1 1 1 1 1 1 1 1 1 9 1 1 7 1 1 7 7 1 7 7 1 1 1 1 1 1 1 1 1 1 1 1 1 1 1 1 1 1 1 1
1 1 1 1 1 1 1 7 7 1 1 9 1 1 1 1 9 1 1 1 1 1 7 1 7 7 1 1 1 7 7 1 1 1 1 1 9 1 1 1 1 1 1 1 1 1 1 1 1 1
1 1 1 1 1 1 1 1 7 7 1 1 1 1 9 1 1 1 1 1 9 1 7 7 7 1 1 1 1 1 7 7 1 1 1 1 1 1 1 1 1 1 1 1 1 9 1 1 1 1
1 1 1 1 1 9 1 1 1 7 7 1 9 1 1 1 1 1 1 1 1 1 7 1 1 1 1 1 9 1 1 7 7 1 1 1 1 1 1 1 1 1 1 1 1 1 1 1 1 1
1 1 1 1 1 1 1 1 1 1 7 7 1 1 1 1 9 1 1 9 1 1 7 1 1 1 1 1 1 1 1 1 7 7 1 1 1 1 1 1 1 1 1 1 1 1 1 1 9 1
1 1 9 1 1 1 1 1 1 1 1 7 1 1 1 1 1 1 1 1 1 1 7 1 1 1 1 1 1 1 1 1 1 7 7 1 1 1 1 1 9 1 1 1 1 1 1 1 1 1
1 1 1 1 1 1 1 1 1 1 1 7 1 1 1 9 1 1 1 1 9 1 7 1 1 1 1 1 9 1 1 1 1 1 7 7 7 1 1 1 1 1 1 1 1 1 1 1 1 1
1 1 9 1 1 1 1 1 1 1 1 7 7 1 1 1 1 1 9 1 1 1 7 1 1 1 1 1 1 1 1 1 1 1 1 1 7 7 1 1 1 1 1 1 9 1 1 1 1 1
1 1 1 1 1 1 1 1 9 1 1 1 7 7 1 1 1 1 1 1 1 1 7 1 1 1 1 1 1 1 1 1 9 1 1 1 1 7 7 1 1 1 1 1 1 1 1 1 1 1
1 1 1 1 1 1 1 1 1 1 1 1 1 7 7 7 1 1 1 9 1 1 7 1 1 1 1 1 1 1 1 1 1 1 1 1 1 1 7 7 1 1 1 1 1 1 1 1 1 1
1 1 1 1 1 1 1 1 1 1 1 1 1 1 1 7 7 1 1 1 1 1 7 1 1 1 9 1 1 1 1 1 1 1 9 1 1 1 1 7 7 1 1 1 1 1 9 1 1 1
1 1 1 9 1 1 1 1 1 1 9 1 1 1 1 1 7 7 1 1 1 1 7 1 1 1 1 1 1 1 1 1 1 1 1 1 1 1 1 1 7 7 1 1 1 1 1 1 1 1
1 1 1 1 1 1 1 1 1 1 1 1 1 1 1 1 1 7 7 1 1 7 7 1 1 1 1 1 1 1 1 1 1 1 1 1 1 1 1 1 1 7 7 7 1 1 1 1 1 1
1 9 1 1 1 1 1 1 1 1 1 1 1 9 1 1 1 1 7 7 1 7 7 1 1 1 1 1 1 1 1 9 1 1 1 1 9 1 1 1 1 1 1 7 7 7 1 1 1 1
1 1 1 1 1 1 1 9 1 1 1 1 1 1 1 1 1 1 1 7 7 7 7 1 1 1 9 1 1 1 1 1 1 1 1 1 1 1 1 1 9 1 1 1 1 7 7 1 1 1